#                           #
#                           #
#                           #
#                           #
#                           #
#                           #
#                           #
#                           #
#                           #
#                           #
#                           #
#                           #
#                           #
#                           #
#                           #
#                           #
#                           #
#                           #
#                           #
#                           #
#                           #
#                           #
#                           #
#                           #
#                           #
#                           #
#                           #
#                           #
#                           #
#                           #
#                           #
#                           #
#                           #
#                           #
#LLLLLLLLLLLLLLLLLLLLLLLLLLL#
#LLLLLLLLLLLLLLLLLLLLLLLLLLL#
#LLLLLLLLLLLLLLLLLLLLLLLLLLL#
#LLLLLLLLLLLLLPLLLLLLLLLLLLL#
#LLLLLLLLLLLLLLLLLLLLLLLLLLL#
#LLLLLLLLLLLLLLLLLLLLLLLLLLL#