#############################
#                           #
#                           #
#    ####                   #
#    #                      #
#    #                      #
#    #                      #
#                           #
#                           #
#               ####        #
#       #                   #
#       #                   #
#       #       #           #
#       #       #           #
#     ###       #           #
#               #           #
#               #           #
#          ########         #
#             #             #
#             #             #
#             #######       #
#             #             #
#             #             #
#         #                 #
#       ####                #
#              #######      #
#                           #
#                           #
#    ####    ######         #
#    #            #         #
#    #            #         #
#    #            #         #
#    #            #         #
#    ####    ######         #
#                       #   #
#                       #   #
#                       #   #
#         H         ####    #
#         T                 #
#############################