o....o...xxx
.........xxx
.o.o...ooxxx
..o...o.o.oo
.......oo.oo
........o.oo
....o......o
...o..o.o..o
............
o......ooo..
.o..o......o
